111111111
1E1110001
100000CP1
111111111